111111111111
100000C11111
10C000011C11
1E0C00000C01
1000P0000001
100C00000001
111111111111
