111111111111
100000011111
10000001111
10000T0000P1
10000C000E01
111111111111
