111111111111
100000011111
100000011111
100000000001
1000P0000001
100000000001
111111111111
