111111111111
100N00C11111
10C000011C11
1E0C00000C01
1P0000000001
100C000N0N01
111111111111
