111111111111
100000C11111
10C000011C11
1E0C00000C01
100000000001
100C000000P1
111111111111
