11111111
1E1000P1
11100101
1C100101
11111111
